%%%%%%%%%%%%%%%%%%%%%%%%%%%%%%
%       % % %              %.%
%       % % %%%%%% %%%%%%% % %
%       %        %     % %   %
%%%%% %%%%% %%% %% %%%%% % %%%
%   % % % %   %    %     %   %
% %%% % % % %%%%%%%% %%% %%% %
%       %     %%     % % %   %
%%% % %%%%%%%G%%%% %%% % % % %
% %           %%     %     % %
% % %%%%% % %%%% % %%% %%% % %
%   %     %      % %   % %%% %
%   %P%%%%%      % %%% %     %
%%%%%%%%%%%%%%%%%%%%%%%%%%%%%%