%%%%%%%%%%%%%%%%%%%%%
%   P               %
%                   %
%                   %
%                   %
%                   %
%                  G%
%                  .%
%%%%%%%%%%%%%%%%%%%%%
