%%%%%%%%
%G     %
%   P  %
% %%%% %
% %    %
% % %%%%
% %   .%
%%%%%%%%
